肯尼亚航空: 肯尼亚
真航空: 韩国真,韩国真航空
亚洲航空公司: 亚洲航空,亚航
德国汉莎航空股份公司: 汉莎航空,汉莎
春秋航空日本: 春秋
法国航空公司: AF,法国航空,法航
马来西亚航空公司: 马来西亚航空,马航
土耳其航空公司: 土耳其航空,土耳其
土耳其货运航空公司: 土耳其货运航空,土耳其货运
巴拉圭航空公司: 巴拉圭地区航空,巴拉圭地区
波兰航空公司: 波兰,波兰航空
胜安航空公司: 胜安,胜安航空
敦煌国际机场: 敦煌机场
赛义德易卜拉欣王子机场: 赛义德·易卜拉欣王子国际机场
德罗什岛机场: 德罗什机场
鸡西兴凯湖机场: 兴凯湖机场
阿尔皮纳郡地区机场: 阿尔皮纳机场
威尼斯马可·波罗国际机场: 马可波罗机场
特克萨卡纳机场: 特克萨卡纳地方机场
达尼丁国际机场: 达尼丁机场
西部航空有限责任公司: 西部,西部航空
广西北部湾航空有限责任公司: 北部湾航空
海南航空股份有限公司: 海航,海南航空
乔莫·肯雅塔国际机场: 内罗毕机场
东营胜利机场: 实里达机场
关岛A.B.WonPat国际机场: 关岛机场
金奈国际机场: 金奈机场
黄金机场: 赣州黄金机场
关岛A.B.WonPat国际机场: 埃弗里特
太原武宿国际机场: 武宿机场
平壤机场: 平壤顺安国际机场
科珀斯科里斯蒂国际机场: 科珀斯科里斯蒂机场
永州零陵机场: 零陵机场
安大略机场: 安大略国际机场
突尼斯机场: 苏梅岛机场
朝阳川机场: 延吉朝阳川国际机场
罗家机场: 景德镇罗家机场
昌北机场: 南昌昌北国际机场
朱诺机场: 朱诺国际机场
佳木斯东郊机场: 东郊机场
南苑机场: 北京南苑机场
遥墙机场: 济南遥墙国际机场
华盛顿杜勒斯国际机场: 杜勒斯机场
奥什机场: 奇科机场
成都航空有限公司: 成都,成都航空
云南祥鹏航空有限责任公司: 祥鹏,祥鹏航空
北京首都航空有限公司: 首都航空,首都
龙江航空有限公司: 龙江航空
福州航空有限责任公司: 福州航空
中国东方航空有限公司: 东方航空,东航
幸福航空: 幸福
重庆航空有限公司: 重庆航空,重庆
中国南方航空股份有限公司: 南方航空
浙江长龙航空有限公司: 长龙航空
九元航空有限公司: 九元,九元航空
华夏航空股份有限公司: 华夏,华夏航空
泰国航空: 泰航
春秋航空股份有限公司: 春秋,春秋航空
金鹏航空公司: 金鹏,RayaAirways
云南红土航空股份有限公司: 红航,红土航空,红土航
长荣航空股份有限公司: 长荣航空,长荣
卡拉奇机场: 卡拉奇真纳国际机场
魁北克机场: 魁北克让·勒萨热国际机场
圣路易斯机场: 兰伯特—圣路易斯国际机场
榆林榆阳机场: 榆阳机场
达勒姆国际机场: 罗利机场
太空城（SpaceCity）: 休斯顿哈比机场
雅温得国际机场: 雅温得机场
诺克斯威尔机场: 诺克斯维尔机场
六盘水月照机场: 苏厄德机场
滨海机场: 天津滨海国际机场
让·保尔·马拉: 马拉
路易斯维尔机场: 斯坦迪福德机场,路易斯威尔机场
池州九华山机场: 九华山机场
印第安纳波利斯机场: 印第安那波利斯国际机场
波特兰喷气机机场: 缅因-波特兰机场
浦那机场: 浦那国际机场
塔什干机场: 塔什干尤日内机场
梳邦国际机场: 吉隆坡梳邦机场
坎布里亚郡机场: 约翰斯顿机场
吴哥机场: 吴哥窟机场
库利亚布: 吴哥窟机场
长水机场: 昆明长水国际机场
辛辛那提机场: 辛辛那提国际机场
西双版纳机场: 西双版纳嘎洒国际机场
巴林国际机场: 巴林机场
南阳姜营机场: 姜营机场
拉萨贡嘎国际机场: 贡嘎机场
温哥华国际机场: 温哥华机场
六盘山机场: 固原机场
加格达奇机场: 加格达奇嘎仙机场
潍坊机场: 潍坊南苑机场
蒙巴萨国际机场: 莫伊国际机场
大兴机场: 北京大兴国际机场
匹兹堡机场: 匹兹堡国际机场
青莱机场: 清莱机场
阿里亚皇后机场: 安曼阿利亚皇后机场
锡亚尔科特机场: 锡亚尔科特国际机场
卢萨卡机场: 卢萨卡国际机场
伊春林都机场: 林都机场
萨那国际机场: 萨那机场
普吉国际机场: 普吉机场
普吉国际机场: 拉各斯机场
巴西利亚机场: 巴西利亚国际机场
梅肯机场: 路易斯－威尔逊机场
里昂机场: 里昂圣埃克絮佩里机场
尼雷尔国际机场: 达累斯萨拉姆机场
菲利普比拉德机场: 罗阿坦机场
安塔那那利佛机场: 塔那那利弗伊瓦图机场
金门尚义: 金门航空站
高崎机场: 厦门高崎国际机场
金湾机场: 珠海金湾国际机场
吉达阿卜杜勒—阿齐兹国王国际机场: 阿卜杜勒-阿齐兹国王机场
努瓦克肖特机场: 武夷山机场
舟山普陀山机场: 普陀山机场
奥尔比亚机场: 奥比亚机场
南郊机场: 绵阳南郊机场
米兰李罗德机场: 利纳特机场
萨尔斯堡机场: 萨尔茨堡机场
塞班国际机场: 塞班机场
迈诺特国际机场: 迈诺特机场
迈诺特机场: 山海关机场
大水泊机场: 威海国际机场
格林斯博罗机场: 信风航空公司
哈瓦那机场: 哈瓦那何塞马蒂机场
布卢梅瑙机场: 绵阳南郊机场
卡利亚里机场: 卡利阿里机场
成都双流国际机场: 双流机场
佛罗伦萨-佩雷托拉亚美利哥·韦斯普奇国际机场: 佛罗伦撒机场
瑙鲁国际机场: 瑙鲁岛国际机场
国家公园机场: 大峡谷机场
栎社机场: 宁波栎社国际机场
米苏拉机场: 约翰逊贝尔机场
广汉机场: 杜阿拉机场
林肯地方机场: LNK
雅典国际机场: 雅典机场
桃花源机场: 常德桃花源机场
澳门机场: 澳门国际机场
纽埃国际机场: 哈南机场
济洲机场: 济州机场
苏城机场: 苏城门户机场
大邱国际机场: 大邱机场
费耶特维尔地方机场: 费耶特维尔机场
泉州晋江国际机场: 晋江机场
苏福尔斯机场: 苏福尔斯地区机场
斯潘塞地方机场: 斯潘塞机场
塞舌尔国际机场: 塞舌尔机场
亚庇国际机场: 亚庇机场
贝尔法斯特市机场: 乔治·贝斯特贝尔法斯特城市机场
郑州新郑国际机场: 新郑机场
圣胡安路易斯·穆尼奥斯·马林国际机场: 圣胡安机场
香格里拉机场: 迪庆香格里拉机场
重庆万州五桥机场: 五桥机场
霍希库塔科机场: 霍希库塔科国际机场
秦皇岛北戴河机场: 秦皇岛北戴河国际机场
拉巴斯机场: 拉巴斯埃尔阿托机场
思茅机场: 普洱（思茅）机场机
肯尼迪机场: 纽约约翰·菲茨杰拉德·肯尼迪国际机场
迈尔斯城机场: 迈尔斯城地方机场
朗勃拉邦机场: 琅勃拉邦国际机场
梅州机场: 长岗岌机场
圣胡安路易斯·穆尼奥斯·马林国际机场: 苏莱曼尼亚机场
伯明翰机场: 伯明翰国际机场
长治王村机场: 王村机场
沈阳桃仙国际机场: 桃仙机场
迪比克机场: 迪比克地方机场
巴拉科阿机场: 巴拉科阿古斯塔沃利索机场
布达佩斯机场: 布达佩斯李斯特•费伦茨国际机场
齐齐哈尔三家子机场: 三家子机场
那霸国际机场: 那霸机场
哈尔格萨机场: 法兰克福哈恩机场
檀香山国际机场: 火奴鲁鲁机场
圣玛丽亚公共机场: 圣玛丽娅机场
得梅因机场: 德梅因机场
圣弗朗西斯科: 三藩市,旧金山机场
和平机场: 日喀则和平机场
史密斯堡地方机场: 史密斯堡机场
克久拉霍机场: 法兰克福哈恩机场
长沙黄花国际机场: 长沙黄花机场
法兰克福国际机场: 法兰克福机场
瑞安机场: 巴吞鲁日机场
纽卡斯尔机场: 黄果树机场
武汉天河国际机场: 天河机场
伯灵顿机场: 仙台机场
长春龙嘉国际机场: 龙嘉机场
的黎波里机场: 的黎波里国际机场
中川机场: 兰州中川国际机场
奥兰多桑福德机场: 桑福德机场
盘龙机场: 博乐机场
博鳌机场: 博鳌国际机场
樟宜机场: 新加坡樟宜国际机场
科利佐沃机场: 叶卡捷琳堡机场
贵阳龙洞堡国际机场: 龙洞堡机场
宝安机场: 深圳宝安国际机场
奥马哈机场: 奥马哈国际机场
拉塔基亚机场: 巴西勒·阿萨德国际机场
布里奇敦国际机场: 布里奇敦
成田国际机场: 成田机场
蒙克顿国际机场: 蒙克顿机场
阿拉山口机场: 博乐机场
潘泰莱里亚机场: 潘泰莱里亚岛机场
科摩罗航空: 科摩罗国际航空,科摩罗
新加坡酷航航空公司: 酷航
UPS快递: UPS
复兴航空: 复兴
美国西北航空公司: 美西北,美国西北航空
阿提哈德航空: 阿联航
乌拉尔航空公司: 乌拉尔,乌拉尔航空
老挝航空: 老挝
阿鲁巴皇家航空公司: 阿鲁巴航空
厄立特里亚航空: 厄立特里亚
北欧航空公司: 北欧,北欧国际航空
三义机场: 丽江三义国际机场
艾因国际机场: 艾因机场
伊斯兰堡机场: 伊斯兰堡贝娜齐尔·布托国际机场
班加罗尔机场: 班加罗尔国际机场
希思罗机场: 伦敦希思罗国际机场
瓦科机场: 瓦科地区机场
兰萨罗特市机场: 兰萨罗特机场
利隆圭国际机场: 利隆圭机场
里斯本机场: 福冈机场
格雷希尔公园机场: 格雷希尔国际公园机场
斯卡圭地方机场: 斯卡圭机场
华沙机场: 华沙-奥肯切弗里德里克·肖邦机场
黑河机场: 黑河瑷珲机场
青山机场扩建工程: 青山机场
首都机场: 北京首都国际机场
威奇塔瀑布市机场: 威奇托福尔斯机场
阿马里洛机场: 里克·哈兹班德阿马里洛国际机场
乌兰察布集宁机场: 阿巴斯港机场
伦敦城市机场: 伦敦城机场
多巴哥岛国际机场: 多巴哥岛机场
张家口机场: 张家口宁远机场
布拉格瓦茨拉夫・哈维尔国际机场: 布拉格机场
锡吉里耶: 张家界荷花国际机场
罗阿诺克机场: 罗阿诺克地方机场
卑尔根Flesland机场: 卑尔根机场
北郊机场: 洛阳北郊机场
四川航空股份有限公司: 川航,四川航空
乌鲁木齐航空有限责任公司: 乌航,乌鲁木齐航空
山东航空股份有限公司: 山航,山东航空
天津航空有限责任公司: 天航,天津航空,天津航
瑞丽航空有限公司: 瑞丽航空,瑞航
奥凯航空有限公司: 奥凯,奥凯航空
东海航空有限公司: 东海航空
上海航空股份有限公司: 上航,上海航空
深圳航空有限责任公司: 深圳航空,深航
厦门航空有限公司: 厦航,厦门航空
白塔埠机场: 连云港白塔埠机场
高坪机场: 南充高坪机场
鞍山机场: 腾鳌机场
张家界荷花国际机场: 荷花机场
黄石区域机场: 科迪机场
河东机场: 银川河东国际机场
水牛城机场: 奥尔堡机场
米切尔将军国际机场: 米切尔机场
天水麦积山机场: 麦积山机场
贝尔普伯尔尼机场: 贝尔普机场
铜仁凤凰国际机场: 凤凰机场
美兰机场: 海口美兰国际机场
班吉机场: 班吉姆波科机场
阿斯马拉机场: 阿斯马拉国际机场
哈尔滨太平国际机场: 太平机场
保安营机场: 兰斯机场
安康富强机场: 安康机场
三亚凤凰国际机场: 凤凰机场
石见机场: 岩见机场
玉龙机场: 赤峰玉龙机场
伊尔施机场: 和田机场
杜兰戈·拉普拉塔机场: 杜兰戈机场
佛山沙堤机场: 沙堤机场,佛山机场
清迈机场: 清迈国际机场
孟买迪拜机场: 孟买机场
布特米尔机场: 萨拉热窝国际机场
广州白云国际机场: 白云机场
廊曼国际机场: 旧曼谷国际机场
大阪关西国际机场: 关西机场
苏南硕放国际机场: 苏南硕放机场
石家庄正定国际机场: 正定机场
大理机场: 奠边府机场
乔治·布什机场: 太空城（SpaceCity）
重庆江北国际机场: 江北机场
布兰太尔奇莱卡国际机场: 布兰太尔机场
拉克鲁丝机场: 拉克鲁丝地方机场
怀化芷江机场: 芷江机场
禄口机场: 南京禄口国际机场
塔林机场: 塔林伦纳特·梅里国际机场
阿姆斯特丹机场: 荷兰阿姆斯特丹国际机场
豌豆岛直升机场: 赫尔辛基直升机场
西雅图机场: 西雅图-塔科马国际机场
蒙彼利埃机场: 蒙彼利埃地中海机场
抚远机场: 抚远东极机场
惠州平潭机场: 惠州机场
拉雷多国际机场: 南京禄口国际机场
曼德勒国际机场: 曼德勒机场
乞力马扎罗山机场: 乞力马扎罗机场
巴尔的摩机场: 巴尔的摩国际机场
埃尔·帕索机场: 埃尔帕索机场
三城市机场: 三连机场
布鲁塞尔国家机场: 布鲁塞尔机场
菜坝机场: 宜宾菜坝机场
凯恩斯机场: 凯恩斯国际机场
开罗国际机场: 开罗机场
路桥机场: 台州路桥机场
卡尔马机场: 卡尔玛机场
纽瓦克机场: 纽华克自由国际机场，EWR
马累国际机场: 马累机场
奥斯汀国际机场: 奥斯汀机场
通化三源浦机场: 通化机场
拉杜尔: 伊宁机场
科斯塔内机场: 科斯塔那机场
淮安涟水机场: 涟水机场
尤马国际机场: 玉马机场
开普敦国际机场: 开普敦机场
维拉港鲍尔费尔德机场: 维拉港机场
天吉泰机场: 巴彦淖尔天吉泰机场
哥伦比亚地区机场: 哥伦比亚机场
萧山机场: 杭州萧山国际机场
德特内里费机场: 特内里费机场
洛杉矶机场: 洛杉矶国际机场
安东尼奥－D388马赛奥机场: 安东尼奥马赛奥机场
弗拉格斯塔夫机场: 费拉格斯塔夫机场
斯科茨布拉夫郡机场: 斯科茨布拉夫机场
上海浦东国际机场: 浦东机场
贝尔格莱德机场: 贝尔格来德机场
热那亚机场: 热那亚—西塞斯特里克里斯托弗·哥伦布国际机场
坎昆机场: 切图马尔国际机场
伦敦卢顿机场: 阿姆利则机场
咸阳机场: 西安咸阳国际机场
冠豸山机场: 龙岩冠豸山机场
法明顿地方机场: 法明顿机场
虹桥机场: 上海虹桥国际机场
青岛流亭国际机场: 流亭机场
斯德哥尔摩阿兰达国际机场: 斯德哥尔摩机场
圣地亚哥: 圣迭戈机场
英迪拉·甘地国际机场: 德里机场
尼古劳·洛巴托总统国际机场: 科摩罗机场
柯克斯维尔地方机场: 柯克斯维尔机场
普莱桑斯国际机场: 毛里求斯机场
金海国际机场: 金海机场
拉伯克机场: 拉伯克国际机场
新潟机场: 新泻机场
泰德·史蒂文斯安克雷奇国际机场: 安克雷奇国际机场
羽田机场: 东京羽田国际机场
费城国际机场: 费城机场
费城国际机场: 清化市
蒙得维的亚Carrasco机场: 卡拉斯科国际机场
米德堡: 比隆机场
泰德·史蒂文斯安克雷奇国际机场: 圣保罗孔戈尼亚斯机场
自由港机场: 弗里波特国际机场
穆罕默德机场: 卡萨布兰卡机场
的里雅斯特机场: 里雅斯特机场
克勒蒙菲朗机场: 克莱蒙费朗机场
关公机场: 运城关公机场
伊比萨岛机场: 伊比萨机场
什里夫波特机场: 什里夫波特地区机场
伍德郡机场: 伍德县机场
厄斯特松德机场: 三女河机场
海浪机场: 牡丹江海浪国际机场
日照山字河机场: 拜县机场
米林机场: 林芝米林机场
阿尔及尔胡阿里·布迈丁机场: 阿尔及尔机场
阿克拉机场: 科托卡国际机场
什里夫波特机场: 德雷斯顿机场
萨克拉门托国际机场: 萨克拉门托大都会机场
阿布扎比机场: 阿布扎比国际机场
仁川机场: 日照山字河机场
圣伊莎贝尔机场: 马拉博机场
张掖机场: 张掖甘州机场
河市机场: 那不勒斯机场
奔牛机场: 常州奔牛国际机场
新舟机场: 遵义新舟机场
特温福尔斯城郡机场: 特温福尔斯机场
鹰县机场: 范尔机场
利马机场: 豪尔赫查韦斯国际机场
温州龙湾国际机场: 龙湾机场
圣乔治机场: 圣乔治地方机场
拉瓜迪机场: 拉瓜迪亚机场
恩施许家坪机场: 许家坪机场
两江机场: 桂林两江国际机场
新贝德福德机场: 新贝尔福特机场
柳州白莲机场: 白莲机场
菲乌米奇诺机场: 罗马菲乌米奇诺机场
乌鲁木齐地窝堡机场: 乌鲁木齐地窝堡国际机场
大庆萨尔图机场: 萨尔图机场
里加机场: 里加国际机场
揭阳潮汕机场: 揭阳潮汕国际机场
曲阜机场: 济宁曲阜机场
克拉根福机场: 维哥机场
堪萨斯城机场: 堪萨斯城地方区机场
长洲岛机场: 圣罗莎机场
大连周水子国际机场: 周水子机场
鹿港机场: 布拉德福德机场
庐山机场: 九江庐山机场
法莱奥洛国际机场: 阿皮亚机场
盐湖城国际机场: 盐湖城机场
呼和浩特白塔国际机场: 白塔机场
中部国际机场: 名古屋中部国际机场
韦恩堡地方巴厄机场: 韦恩堡国际机场
乔治城OwenRoberts国际机场: 乔治城国际机场
渥太华机场: 渥太华麦克唐纳—卡蒂埃国际机场
梅克内斯机场: 福特法机场
圣多美岛机场: 圣多美机场
长乐机场: 福州长乐国际机场
特克斯和凯科斯群岛国际机场: 普罗维登西亚莱斯国际机场
宜昌三峡机场: 三峡机场
科纳克里格贝西亚机场: 科纳克里机场
麦卡伦机场: 拉斯维加斯麦卡伦国际机场
南通兴东国际机场: 兴东机场
金兰机场: 金兰国际机场
曹家堡机场: 西宁曹家堡机场
朝阳机场: 阿克苏机场
麦德林何塞·玛丽亚·科尔多瓦国际机场: 麦德林机场
喀布尔机场: 喀布尔国际机场
浪头机场: 海于格松机场
南洋机场: 盐城南洋国际机场
波哥大埃尔多拉国际机场: 波哥大Eldorado机场
黄金海岸机场: 麦卡伦国际机场
二里半机场: 包头二里半机场
巴罗达机场: 瓦多达拉（巴罗达）机机场
新桥机场: 合肥新桥国际机场
阿布贾国际机场: 阿布贾机场
哈拉雷国际机场: 哈拉雷机场
斯里巴加湾机场: 文莱斯里巴加湾国际机场
贝鲁特拉菲克·哈里里国际机场: 贝鲁特机场
波德戈里察机场: 填写人物波德戈里察机场中文名或其中文译名
马德拉丰沙尔克里斯蒂亚诺·罗纳尔多机场: 马德拉岛机场
阿米尔卡－卡布拉尔国际机场: 阿米尔卡-卡布拉尔国际机场
田阳机场: 百色巴马机场
静冈国际机场: 静冈机场
赛乌苏机场: 二连浩特赛乌苏国际机场
香港国际机场: 赤鱲角机场
坎皮纳斯国际机场: 坎皮纳斯机场
交河机场: 吐鲁番交河机场
维多利亚机场: 卢班戈机场
悉尼金斯福德·史密斯国际机场: 悉尼机场
扬斯敦机场: 扬斯顿机场
克拉斯诺尔斯克机场: 克拉斯诺亚尔斯克机场
斯普林菲尔德机场: 布兰森地区机场
黄山屯溪国际机场: 屯溪机场
斯卡特航空公司: 斯卡特,斯卡特航空
全日本空输株式会社: 全日空航空,全日空
泰国东方航空: 泰国东方
美国航空: 美航
墨西哥西部航空公司: 墨西哥西部,墨西哥西部航空
英国航空公司: 英航,英国航空
极地货运航空公司: 极地货运航空,极地货运
柏林航空: 柏林
阿拉斯加航空公司: 阿拉斯加航空
西藏航空有限公司: 西藏航空,西藏
阿拉伯联合酋长国航空公司（阿联酋航空公司）: 阿航,阿联酋航空
河北航空有限公司: 河北航空,河北
上海吉祥航空有限公司: 吉祥航空,吉祥
青岛航空股份有限公司: 青岛,青岛航空
长安航空有限责任公司: 长安,长安航空
江西航空投资有限公司: 江西航空
昆明航空有限公司: 昆明航空,昆航
大新华航空有限公司: 大新华航空,大新华
华信航空股份有限公司: 华信,华信航空
香港快运航空: 香港快运
JSC"BekAir: JSC"BekAir",BekAir
柬埔寨巴戎航空有限公司: 柬埔寨巴戎航空
空中世界航空: 空中世界,空中世界-乌克兰航空公司
釜山航空: 釜山
海参崴航空: 海参崴
济州航空: 济州
澳洲航空: 澳洲,澳大利亚快达航空公司
TAP葡萄牙航空: TAP
达美航空: 达美,三角洲航空
美国大陆航空公司: 大陆,大陆航空
维珍航空: 维珍
中国联合航空有限公司: 中国联航,中联航,联合航空
伊朗航空: 伊朗
阿里亚纳阿富汗航空公司: 阿里亚纳阿富汗航空,阿富汗
亚特兰大冰岛航空: 冰岛亚特兰大航空,亚特兰大
菲鹰航空: 菲律宾
约旦皇家航空: 约旦皇家
沙特阿拉伯航空: 沙特航空
匈牙利航空公司: 匈牙利,匈牙利航空
澳门航空: 澳门
菲律宾航空: 菲航
坦桑尼亚精密航空公司: 精密,精密航空
芬兰航空公司: 芬航,芬兰航空
印度航空公司: 印度航空,印度
乌克兰航空公司: 乌克兰航空,乌克兰
泰国都市航空: 都市航空,泰国都市
立荣航空公司: 立荣,立荣航空
中国国际航空股份有限公司: 中国国航,国航
俄罗斯普尔科沃航空公司: 普尔科沃航空,普尔科沃
新加坡航空: 新航
台湾虎航: 法国国内
意大利航空: 意大利
印度快线航空公司: 印尼城市快线航空
阿斯塔纳航空公司: 阿斯塔纳航空,哈萨克斯坦
海湾航空: 海湾
冰岛航空: 冰岛
安哥拉航空公司: 安哥拉航空,安哥拉
坦桑尼亚航空公司: 坦桑尼亚航空
飞鸟航空（泰国皇雀航空）: 飞鸟航空,飞鸟
哈萨克斯坦国际航空: 哈萨克斯坦
日本航空公司: 日航,日本航空
韩国大韩航空公司（大韩航空株式会社）: 大韩,大韩航空
顺丰航空: 顺丰
奥地利航空: 奥航
泰国亚洲航空: 泰国亚洲航空公司,泰亚航
埃及航空: 埃及
津巴布韦航空: 津巴布韦国家航空公司,津巴布韦
A-7攻击机: Corsair
香料航空公司: 印度香料航空
挪威航空: 挪威
智利航空: 智利
俄罗斯雅库特航空公司: 雅库特航空
远东航空: 远东
中国飞龙专业航空公司: 飞龙专业航空,飞龙航空
易斯达航空公司: 易斯达,易斯达航空
塔希提航空: 塔希提
蓝色航空: BucharestBăneasa
高丽航空公司: 高丽航空
国泰航空有限公司: 国泰航空,国泰
越南航空: 越南
塞内加尔共和国: 塞内加尔
南非航空: 南非
新西兰航空公司: 新西兰,新西兰航空
世界航天: 世界航空,世界航
中华航空股份有限公司: 中华,中华航空
精神航空公司: 精神航空
以色列航空: 以色列
萨哈林航空: 萨哈林
卡塔尔航空公司: 卡塔尔,卡塔尔航空
赤塔航空公司: 赤塔航空,赤塔
鲲鹏航空有限公司: 鲲鹏,鲲鹏航空
韩亚航空公司: 韩亚航空,韩亚
湄公航空: 湄公
中国货运航空: 中货航
荷兰皇家航空公司: 荷兰皇家航空,荷兰皇家
长青国际航空: 长青国际
北欧航空公司: 北欧,北欧航空
加拿大航空: 加航
斯里兰卡航空公司: 斯里兰卡,斯里兰卡航空,斯里拉卡航空
国泰港龙航空: 国泰港龙,港龙,港龙航空
旅行航空公司: 旅行,旅行航空
阿尔及利亚航空: 阿尔及利亚
香港航空有限公司: 香港航空,港航
爱尔兰航空公司: 爱尔兰航空
美国联合航空: 美联航
曼谷航空: 曼谷
埃塞俄比亚航空: 埃塞俄比亚
蒙古民用航空: 蒙古航空民用,蒙古
易易紫: 易秋兰,婷儿,Niki,紫宝贝
俄罗斯洲际航空: 全禄航空
利得国际航空公司: 利得国际航空,利得航空
汤普森航空公司: 汤普森航空,汤普森
阿塞拜疆航空货运公司: SilkWay,阿塞拜疆航空货运
埃及休闲航空公司: 埃及休闲
AirasiaAirline: 印尼亚洲航空
UkraineInternationalAirlines: 乌克兰国际航空
德国汉亚航空公司: 汉亚航空,汉亚
SimpliflyDeccan: Simplifly德干
维德勒航空公司: 维德勒航空
马达加斯加航空公司: 马达加斯加,马达加斯加航空
嘉鲁达印尼航空公司(印度尼西亚): 嘉鲁达印尼,嘉鲁达印尼航空公司,鹰航
天翼亚洲航空公司: 天翼,天翼亚洲航空
南非鹈鹕航空: 鹈鹕,鹈鹕航空
StarAir: 明星航空公司
阿拉比亚航空: 阿拉伯航空
Tunisair: 突尼斯航空
NationalAirServices(NAS): 国家航空服务公司
卢森堡货运国际航空公司: 卢森堡,卢森堡货运航空
MalindoAir: 马印航空
ATAAirlines: 美国泛航航空公司
OmniAirInternational: 全能国际航空
澳大利亚欣丰虎航空有限公司: 澳洲虎航
尼奥斯航空: 尼奥斯航空公司
NordicAirlink(FlyNordic): 北欧飞行航空
SaudiGulfAirlines: saudigulf
WestJetEncoreLtd.: WestJetEncore
TransaviaFrance: 法国泛航航空
JC（柬埔寨）国际航空: JC航空,JC国际航空,柬埔寨景成国际航空
SkyRegionalAirlines: SkyRegional
AirCairo: 卡里奥航空公司
I-Fly航空公司: I-Fly航空,I-Fly
泰国越捷航空公司: 泰国越捷航空
laoskyway航空公司: Kyrgyz航空公司
英国国际直升机航空: 英国国际直升机
美国西南航空公司: SouthwestAirlines
伏尔加第聂伯航空公司: 伏尔加第聂伯,伏尔加第聂伯航空
SudanAirways: 苏丹航空
巴基斯坦蓝色航空公司: 蓝色航空公司
HOP!航空公司: 法航所属航空
FrontierAirlines: 边疆航空
土耳其MNG航空公司: 土耳其MNB航空公司
MountCookAirlines: MountCook
尼泊尔皇家航空公司: 尼泊尔皇家航空,尼泊尔皇家
塞拉太平洋航空公司: 塞拉太平洋,塞拉太平洋航空
TranStar航空公司: TranStar航空
TUIfly: 哈帕克－劳埃德快运航空
Jambojet: jambojet
克拉斯诺雅茨克航空: 克拉斯,克拉斯航空
MahanAirlines: 马汉航空
澜湄航空（柬埔寨）股份有限公司: 澜湄航空,澜媚航空
捷星太平洋航空: 捷星太平洋
诺斯达航空公司: 诺斯达,诺斯达航空
加雷姆航空: 斯加雷姆航空,俄罗斯加雷姆航空
Yanair: 乌克兰燕航空
吉尔吉斯斯坦航空公司: 吉尔吉斯斯坦,吉尔吉斯斯坦航空
SriwijayaAir: 三佛齐航空
ScottAir: 斯科特航空
诺德文德航空公司: 诺德文德,诺德文德航空
玻利维亚航空公司: 玻利维亚航空
TradewindsAirlines: 信风航空
ArikAir: 阿利克航空
BritishAirtours航空公司: BritishAirtours航空
SkyWings: 天空之翼航空公司
AZUL-LinhasAereasBrasileiras: LinhasAereasBrasileiras
飞龙航空公司: 飞龙航空,飞龙
ThaiSmileAirwaysCompanyLimited: 泰国微笑航空
德威航空公司: 德威航空,德威
EznisAirwaysCo.Ltd.: 伊斯尼斯航空
AtlasGlobalAirlines: Atlasglobal
缅甸航空公司: 缅甸航空
施莱纳航空公司公司: 施莱纳航空
TulipAir: 郁金香航空
ShaheenAir: 沙欣航空公司
柬埔寨洞里萨航空: 洞里萨航空,洞里萨
空桥货运航空公司: 空桥货运航空,空桥货运
塔吉克斯坦航空公司: 塔吉克斯坦,塔吉克斯坦航空
太阳之翼航空公司: SunwingAirlines
布拉森斯区域航空公司: 布拉森斯,布拉森斯区域航空
巴伐利亚: 巴伐利亚航空,BPA
Globus航空公司: Globus航空,Globus
斯凯威航空公司: 斯凯威航空,斯凯威
乌兹别克斯坦航空公司: 乌兹别克斯坦,乌兹别克斯坦航空
SmartLynx: SmartLynx航空公司
Zip: ZIP航空
AzmanAirServicesLimited: 阿兹曼航空
马尔代夫美佳航空公司: 西伯利亚泛空,美佳航空
安琪航空公司: 安琪,安琪航空
云南英安航空公司: 英安航空
Aeromar: 大湖航空
TransafrikInternational: 泛非国际航空
蒙古航空公司: 蒙古,蒙古航空
卢森堡意大利航空公司: 卢森堡意大利航空
OLTExpressGermany: OLT航空公司
泰国新时代航空公司: 泰国新时代航空
柬埔寨百善航空公司: 百善航空公司
西伯利亚航空公司: 西伯利亚,西伯利亚航空
HelittLíneasAéreas: Helitt航空
SkyserviceAirlines: 服务航空公司
伊朗旅行航空公司: 伊朗旅行,伊朗航空旅行
香港华民航空: 香港,香港华民
TransliftAirways: 泛空运航空公司
匈奴航空公司: 蒙古,匈奴航空
基什航空航空公司: 基什航空航空
印尼城市快线航空公司: 印尼城市快线航空,印度尼西亚城市快线航空
SkyAirline: 天空航空公司
BigSkyAirlines: 大天空航空公司
VAirCorporation: 威航,台湾威航空
TransTravelAirlines: 美国海外航空
文莱皇家航空公司: 文莱皇家航空,文莱皇家
索蒙航空公司: 索蒙,索蒙航空
塞内加尔航空公司: TRANSAIR
伊拉克航空公司: 伊拉克航空,伊拉克
SunCountryAirlines: 阳光之乡航空
日本货运航空公司: 日本货运航空,日本货运
MayaIslandAir: 马雅岛航空公司
Bukovyna航空公司: Bukovyna航空
BoraJet航空公司: BoraJet,BoraJet航空
AirTahitiNui（THT）: 大溪地航空（THT）
AircompanySomonAirLLC: 索门航空公司
津巴布韦AvientAviation航空公司: AvientAviation航空,AvientAviation
宿务太平洋航空公司: 宿务太平洋航空,宿务太平洋
巴西: 巴西航空
伊朗阿斯曼航空公司: 阿斯曼,伊朗阿斯曼航空
加勒比之星航空有限公司: 加勒比之星航空,加勒比之星
VirginAmerica: 维珍美国航空
KLMCityhopper航空: 荷兰皇家航空城市短途公司
土库曼斯坦航空: 土库曼斯坦
AeroLogic货运: AeroLogic货运航空
747系列: 波音747
机体结构: 飞机部分
安全检查: 安检
餐饮服务: 吃的
餐饮服务: 早餐
行李收运: 带重
机体结构: 主要部分
中国南方航空股份有限公司: 中国最大的航空公司
